{
	"numTilesX": 13,
	"numTilesY": 10,
	"size": [64, 64],
	"start": [32, 32],
	"tileNames": ["", "tile01", "tile02"],
	"tiles": [
			0, 0, 0, 0, 0, 0, 0, 0, 0, 0, 0, 0, 0,
			0, 0, 0, 0, 0, 0, 0, 0, 0, 0, 0, 0, 0,
			0, 0, 0, 0, 0, 0, 0, 0, 0, 0, 0, 0, 0,
			0, 0, 0, 0, 0, 2, 2, 2, 0, 0, 0, 0, 0,
			2, 0, 0, 0, 0, 0, 1, 0, 0, 0, 0, 0, 2,
			1, 0, 2, 2, 0, 0, 0, 0, 0, 2, 2, 0, 1,
			1, 0, 1, 0, 0, 0, 0, 0, 0, 0, 1, 0, 1,
			1, 0, 0, 0, 0, 0, 0, 0, 0, 0, 0, 0, 1,
			1, 0, 0, 0, 2, 0, 0, 0, 2, 0, 0, 0, 1,
			2, 2, 2, 2, 1, 2, 2, 2, 1, 2, 2, 2, 2
			  ]
}